WE ./assets/WE.xpm
EA ./assets/EA.xpm
NO ./assets/anaji-el.xpm
SO ./assets/akarafi.xpm


F 2,15,170
C 0,119,179



        1111 11111111111111111111
11      1001 1000110000000000001
10     101111001110000001010001
        100100000000000000000S001
111111111011000001110000000100001
100000000011000001110101111111111
11110111111111011000000010001
11000111111111011101010010001
11011111111111111111110111111
101                 101
11011111111111111111110111111
11000000110000001100000000001
10001000000000001100000011001
10000000000000001101010011001
1100000111010101111101111000111
11110111 1110101 101111110001
11111111 1111111 111111111111